"","ident","Successes","anwesend","valid","Sucess_share","enthaltung","Name","PersonNumber","ParlGroupName"
"1","Ada Marra_Sozialdemokratische Fraktion",609,734,697,0.829700272479564,37,"Ada Marra",3923,"Sozialdemokratische Fraktion"
"2","Adèle Thorens Goumaz_Grüne Fraktion",576,687,645,0.838427947598253,42,"Adèle Thorens Goumaz",3907,"Grüne Fraktion"
"3","Adrian Amstutz_Fraktion der Schweizerischen Volkspartei",362,689,647,0.525399129172714,42,"Adrian Amstutz",1135,"Fraktion der Schweizerischen Volkspartei"
"4","Alain Ribaux_FDP-Liberale Fraktion",320,341,339,0.93841642228739,2,"Alain Ribaux",4111,"FDP-Liberale Fraktion"
"5","Albert Rösti_Fraktion der Schweizerischen Volkspartei",406,691,661,0.587554269175109,30,"Albert Rösti",4100,"Fraktion der Schweizerischen Volkspartei"
"6","Albert Vitali_FDP-Liberale Fraktion",667,731,727,0.912448700410397,4,"Albert Vitali",4054,"FDP-Liberale Fraktion"
"7","Alec von Graffenried_Grüne Fraktion",520,581,563,0.895008605851979,18,"Alec von Graffenried",3908,"Grüne Fraktion"
"8","Alexander Tschäppät_Sozialdemokratische Fraktion",567,666,630,0.851351351351351,36,"Alexander Tschäppät",224,"Sozialdemokratische Fraktion"
"9","Alfred Heer_Fraktion der Schweizerischen Volkspartei",289,611,569,0.472995090016367,42,"Alfred Heer",3887,"Fraktion der Schweizerischen Volkspartei"
"10","Aline Trede_Grüne Fraktion",366,478,436,0.765690376569038,42,"Aline Trede",4128,"Grüne Fraktion"
"11","Alois Gmür_Fraktion CVP-EVP",684,719,717,0.951321279554937,2,"Alois Gmür",4096,"Fraktion CVP-EVP"
"12","André Bugnon_Fraktion der Schweizerischen Volkspartei",422,676,640,0.624260355029586,36,"André Bugnon",453,"Fraktion der Schweizerischen Volkspartei"
"13","Andrea Caroni_FDP-Liberale Fraktion",612,706,671,0.86685552407932,35,"Andrea Caroni",4075,"FDP-Liberale Fraktion"
"14","Andrea Martina Geissbühler_Fraktion der Schweizerischen Volkspartei",357,671,610,0.53204172876304,61,"Andrea Martina Geissbühler",3880,"Fraktion der Schweizerischen Volkspartei"
"15","Andreas Aebi_Fraktion der Schweizerischen Volkspartei",456,708,650,0.644067796610169,58,"Andreas Aebi",3867,"Fraktion der Schweizerischen Volkspartei"
"16","Andreas Gross_Sozialdemokratische Fraktion",410,502,465,0.816733067729084,37,"Andreas Gross",97,"Sozialdemokratische Fraktion"
"17","Andy Tschümperlin_Sozialdemokratische Fraktion",629,742,719,0.847708894878706,23,"Andy Tschümperlin",3829,"Sozialdemokratische Fraktion"
"18","Anne Mahrer_Grüne Fraktion",301,358,343,0.840782122905028,15,"Anne Mahrer",4136,"Grüne Fraktion"
"19","Antonio Hodgers_Grüne Fraktion",270,331,312,0.81570996978852,19,"Antonio Hodgers",3889,"Grüne Fraktion"
"20","Balthasar Glättli_Grüne Fraktion",596,742,698,0.803234501347709,44,"Balthasar Glättli",4093,"Grüne Fraktion"
"21","Barbara Gysi_Sozialdemokratische Fraktion",604,741,698,0.815114709851552,43,"Barbara Gysi",4121,"Sozialdemokratische Fraktion"
"22","Barbara Schmid-Federer_Fraktion CVP-EVP",618,652,633,0.947852760736196,19,"Barbara Schmid-Federer",3904,"Fraktion CVP-EVP"
"23","Bastien Girod_Grüne Fraktion",576,698,654,0.825214899713467,44,"Bastien Girod",3882,"Grüne Fraktion"
"24","Bea Heim_Sozialdemokratische Fraktion",595,739,674,0.805142083897158,65,"Bea Heim",1156,"Sozialdemokratische Fraktion"
"25","Beat Flach_Grünliberale Fraktion",672,724,717,0.92817679558011,7,"Beat Flach",4059,"Grünliberale Fraktion"
"26","Beat Jans_Sozialdemokratische Fraktion",621,736,703,0.84375,33,"Beat Jans",4032,"Sozialdemokratische Fraktion"
"27","Beat Walti_FDP-Liberale Fraktion",248,272,266,0.911764705882353,6,"Beat Walti",4142,"FDP-Liberale Fraktion"
"28","Bernhard Guhl_Fraktion BD",718,749,735,0.958611481975968,14,"Bernhard Guhl",4082,"Fraktion BD"
"29","Bruno Pezzatti_FDP-Liberale Fraktion",582,680,659,0.855882352941176,21,"Bruno Pezzatti",4084,"FDP-Liberale Fraktion"
"30","Bruno Zuppiger_Fraktion der Schweizerischen Volkspartei",86,155,143,0.554838709677419,12,"Bruno Zuppiger",526,"Fraktion der Schweizerischen Volkspartei"
"31","Carlo Sommaruga_Sozialdemokratische Fraktion",554,688,647,0.805232558139535,41,"Carlo Sommaruga",1120,"Sozialdemokratische Fraktion"
"32","Caspar Baader_Fraktion der Schweizerischen Volkspartei",230,476,436,0.483193277310924,40,"Caspar Baader",404,"Fraktion der Schweizerischen Volkspartei"
"33","Cédric Wermuth_Sozialdemokratische Fraktion",567,700,655,0.81,45,"Cédric Wermuth",4057,"Sozialdemokratische Fraktion"
"34","Céline Amaudruz_Fraktion der Schweizerischen Volkspartei",427,712,671,0.599719101123595,41,"Céline Amaudruz",4090,"Fraktion der Schweizerischen Volkspartei"
"35","Cesla Amarelle_Sozialdemokratische Fraktion",583,712,673,0.818820224719101,39,"Cesla Amarelle",4107,"Sozialdemokratische Fraktion"
"36","Chantal Galladé_Sozialdemokratische Fraktion",591,669,650,0.883408071748879,19,"Chantal Galladé",1125,"Sozialdemokratische Fraktion"
"37","Christa Markwalder_FDP-Liberale Fraktion",680,720,708,0.944444444444444,12,"Christa Markwalder",1139,"FDP-Liberale Fraktion"
"38","Christian Levrat_Sozialdemokratische Fraktion",86,101,94,0.851485148514851,7,"Christian Levrat",1150,"Sozialdemokratische Fraktion"
"39","Christian Lohr_Fraktion CVP-EVP",667,690,685,0.966666666666667,5,"Christian Lohr",4118,"Fraktion CVP-EVP"
"40","Christian Lüscher_FDP-Liberale Fraktion",633,683,676,0.926793557833089,7,"Christian Lüscher",3895,"FDP-Liberale Fraktion"
"41","Christian Miesch_Fraktion der Schweizerischen Volkspartei",104,248,248,0.419354838709677,0,"Christian Miesch",151,"Fraktion der Schweizerischen Volkspartei"
"42","Christian van Singer_Grüne Fraktion",603,741,674,0.813765182186235,67,"Christian van Singer",3924,"Grüne Fraktion"
"43","Christian Wasserfallen_FDP-Liberale Fraktion",624,726,701,0.859504132231405,25,"Christian Wasserfallen",3912,"FDP-Liberale Fraktion"
"44","Christine Bulliard-Marbach_Fraktion CVP-EVP",676,696,690,0.971264367816092,6,"Christine Bulliard-Marbach",4101,"Fraktion CVP-EVP"
"45","Christine Häsler_Grüne Fraktion",79,90,89,0.877777777777778,1,"Christine Häsler",4149,"Grüne Fraktion"
"46","Christoph Blocher_Fraktion der Schweizerischen Volkspartei",116,319,282,0.363636363636364,37,"Christoph Blocher",21,"Fraktion der Schweizerischen Volkspartei"
"47","Christoph Mörgeli_Fraktion der Schweizerischen Volkspartei",286,626,596,0.456869009584665,30,"Christoph Mörgeli",542,"Fraktion der Schweizerischen Volkspartei"
"48","Christophe Darbellay_Fraktion CVP-EVP",624,643,640,0.97045101088647,3,"Christophe Darbellay",1133,"Fraktion CVP-EVP"
"49","Claudia Friedl_Sozialdemokratische Fraktion",414,499,476,0.829659318637275,23,"Claudia Friedl",4131,"Sozialdemokratische Fraktion"
"50","Corina Eichenberger-Walther_FDP-Liberale Fraktion",658,716,706,0.918994413407821,10,"Corina Eichenberger-Walther",3875,"FDP-Liberale Fraktion"
"51","Corrado Pardini_Sozialdemokratische Fraktion",580,703,665,0.825035561877667,38,"Corrado Pardini",4045,"Sozialdemokratische Fraktion"
"52","Daniel Fässler_Fraktion CVP-EVP",526,577,556,0.911611785095321,21,"Daniel Fässler",4056,"Fraktion CVP-EVP"
"53","Daniel Jositsch_Sozialdemokratische Fraktion",578,654,639,0.883792048929664,15,"Daniel Jositsch",3891,"Sozialdemokratische Fraktion"
"54","Daniel Stolz_FDP-Liberale Fraktion",462,524,510,0.881679389312977,14,"Daniel Stolz",4126,"FDP-Liberale Fraktion"
"55","Daniel Vischer_Grüne Fraktion",553,712,652,0.776685393258427,60,"Daniel Vischer",1110,"Grüne Fraktion"
"56","Daniela Schneeberger_FDP-Liberale Fraktion",676,750,748,0.901333333333333,2,"Daniela Schneeberger",4060,"FDP-Liberale Fraktion"
"57","Dominique de Buman_Fraktion CVP-EVP",702,731,720,0.960328317373461,11,"Dominique de Buman",1124,"Fraktion CVP-EVP"
"58","Doris Fiala_FDP-Liberale Fraktion",648,722,701,0.897506925207756,21,"Doris Fiala",3877,"FDP-Liberale Fraktion"
"59","Edith Graf-Litscher_Sozialdemokratische Fraktion",636,729,704,0.872427983539095,25,"Edith Graf-Litscher",1295,"Sozialdemokratische Fraktion"
"60","Elisabeth Schneider-Schneiter_Fraktion CVP-EVP",704,723,717,0.97372060857538,6,"Elisabeth Schneider-Schneiter",4040,"Fraktion CVP-EVP"
"61","Eric Nussbaumer_Sozialdemokratische Fraktion",606,716,683,0.846368715083799,33,"Eric Nussbaumer",3899,"Sozialdemokratische Fraktion"
"62","Eric Voruz_Sozialdemokratische Fraktion",521,625,589,0.8336,36,"Eric Voruz",3911,"Sozialdemokratische Fraktion"
"63","Erich von Siebenthal_Fraktion der Schweizerischen Volkspartei",407,708,652,0.574858757062147,56,"Erich von Siebenthal",3910,"Fraktion der Schweizerischen Volkspartei"
"64","Ernst Schibli_Fraktion der Schweizerischen Volkspartei",145,300,296,0.483333333333333,4,"Ernst Schibli",820,"Fraktion der Schweizerischen Volkspartei"
"65","Evi Allemann_Sozialdemokratische Fraktion",634,734,710,0.863760217983651,24,"Evi Allemann",1131,"Sozialdemokratische Fraktion"
"66","Fabio Regazzi_Fraktion CVP-EVP",695,746,721,0.931635388739946,25,"Fabio Regazzi",4072,"Fraktion CVP-EVP"
"67","Fathi Derder_FDP-Liberale Fraktion",663,707,698,0.937765205091938,9,"Fathi Derder",4079,"FDP-Liberale Fraktion"
"68","Felix Müri_Fraktion der Schweizerischen Volkspartei",398,734,707,0.542234332425068,27,"Felix Müri",1111,"Fraktion der Schweizerischen Volkspartei"
"69","Filippo Leutenegger_FDP-Liberale Fraktion",281,375,334,0.749333333333333,41,"Filippo Leutenegger",1113,"FDP-Liberale Fraktion"
"70","Francine John-Calame_Grüne Fraktion",596,731,687,0.815321477428181,44,"Francine John-Calame",1293,"Grüne Fraktion"
"71","Franziska Teuscher_Grüne Fraktion",214,255,242,0.83921568627451,13,"Franziska Teuscher",359,"Grüne Fraktion"
"72","Fulvio Pelli_FDP-Liberale Fraktion",304,332,331,0.91566265060241,1,"Fulvio Pelli",345,"FDP-Liberale Fraktion"
"73","Gabi Huber_FDP-Liberale Fraktion",663,752,733,0.881648936170213,19,"Gabi Huber",1103,"FDP-Liberale Fraktion"
"74","Gerhard Pfister_Fraktion CVP-EVP",598,695,648,0.860431654676259,47,"Gerhard Pfister",1109,"Fraktion CVP-EVP"
"75","Geri Müller_Grüne Fraktion",536,671,630,0.798807749627422,41,"Geri Müller",1112,"Grüne Fraktion"
"76","Giovanni Merlini_FDP-Liberale Fraktion",311,329,329,0.945288753799392,0,"Giovanni Merlini",4140,"FDP-Liberale Fraktion"
"77","Gregor Rutz_Fraktion der Schweizerischen Volkspartei",215,486,449,0.44238683127572,37,"Gregor Rutz",4125,"Fraktion der Schweizerischen Volkspartei"
"78","Guillaume Barazzone_Fraktion CVP-EVP",292,309,302,0.944983818770227,7,"Guillaume Barazzone",4138,"Fraktion CVP-EVP"
"79","Guy Parmelin_Fraktion der Schweizerischen Volkspartei",462,748,685,0.617647058823529,63,"Guy Parmelin",1108,"Fraktion der Schweizerischen Volkspartei"
"80","Hans-Jürg Fehr_Sozialdemokratische Fraktion",276,339,323,0.814159292035398,16,"Hans-Jürg Fehr",464,"Sozialdemokratische Fraktion"
"81","Hans-Peter Portmann_FDP-Liberale Fraktion",241,276,275,0.873188405797101,1,"Hans-Peter Portmann",4141,"FDP-Liberale Fraktion"
"82","Hans Egloff_Fraktion der Schweizerischen Volkspartei",386,689,666,0.560232220609579,23,"Hans Egloff",4110,"Fraktion der Schweizerischen Volkspartei"
"83","Hans Fehr_Fraktion der Schweizerischen Volkspartei",320,688,661,0.465116279069767,27,"Hans Fehr",319,"Fraktion der Schweizerischen Volkspartei"
"84","Hans Grunder_Fraktion BD",508,543,533,0.935543278084715,10,"Hans Grunder",3886,"Fraktion BD"
"85","Hans Kaufmann_Fraktion der Schweizerischen Volkspartei",207,414,382,0.5,32,"Hans Kaufmann",479,"Fraktion der Schweizerischen Volkspartei"
"86","Hans Killer_Fraktion der Schweizerischen Volkspartei",436,745,721,0.585234899328859,24,"Hans Killer",3892,"Fraktion der Schweizerischen Volkspartei"
"87","Hansjörg Hassler_Fraktion BD",707,727,722,0.972489683631362,5,"Hansjörg Hassler",473,"Fraktion BD"
"88","Hansjörg Knecht_Fraktion der Schweizerischen Volkspartei",430,736,722,0.584239130434783,14,"Hansjörg Knecht",4114,"Fraktion der Schweizerischen Volkspartei"
"89","Hansjörg Walter_Fraktion der Schweizerischen Volkspartei",332,513,497,0.647173489278752,16,"Hansjörg Walter",519,"Fraktion der Schweizerischen Volkspartei"
"90","Hansruedi Wandfluh_Fraktion der Schweizerischen Volkspartei",334,518,506,0.644787644787645,12,"Hansruedi Wandfluh",520,"Fraktion der Schweizerischen Volkspartei"
"91","Heinz Brand_Fraktion der Schweizerischen Volkspartei",407,688,651,0.591569767441861,37,"Heinz Brand",4067,"Fraktion der Schweizerischen Volkspartei"
"92","Heinz Siegenthaler_Fraktion BD",188,193,191,0.974093264248705,2,"Heinz Siegenthaler",4146,"Fraktion BD"
"93","Hildegard Fässler-Osterwalder_Sozialdemokratische Fraktion",220,257,246,0.856031128404669,11,"Hildegard Fässler-Osterwalder",395,"Sozialdemokratische Fraktion"
"94","Hugues Hiltpold_FDP-Liberale Fraktion",699,745,744,0.938255033557047,1,"Hugues Hiltpold",3888,"FDP-Liberale Fraktion"
"95","Ida Glanzmann-Hunkeler_Fraktion CVP-EVP",697,724,715,0.962707182320442,9,"Ida Glanzmann-Hunkeler",1337,"Fraktion CVP-EVP"
"96","Ignazio Cassis_FDP-Liberale Fraktion",672,725,717,0.926896551724138,8,"Ignazio Cassis",3828,"FDP-Liberale Fraktion"
"97","Isabelle Chevalley_Grünliberale Fraktion",624,671,660,0.929955290611028,11,"Isabelle Chevalley",4108,"Grünliberale Fraktion"
"98","Isabelle Moret_FDP-Liberale Fraktion",679,721,713,0.941747572815534,8,"Isabelle Moret",1346,"FDP-Liberale Fraktion"
"99","Jacqueline Badran_Sozialdemokratische Fraktion",559,651,620,0.858678955453149,31,"Jacqueline Badran",4058,"Sozialdemokratische Fraktion"
"100","Jacqueline Fehr_Sozialdemokratische Fraktion",533,645,611,0.826356589147287,34,"Jacqueline Fehr",405,"Sozialdemokratische Fraktion"
"101","Jacques-André Maire_Sozialdemokratische Fraktion",614,727,694,0.844566712517194,33,"Jacques-André Maire",4018,"Sozialdemokratische Fraktion"
"102","Jacques Bourgeois_FDP-Liberale Fraktion",680,726,717,0.9366391184573,9,"Jacques Bourgeois",3872,"FDP-Liberale Fraktion"
"103","Jacques Neirynck_Fraktion CVP-EVP",620,662,643,0.936555891238671,19,"Jacques Neirynck",498,"Fraktion CVP-EVP"
"104","Jakob Büchler_Fraktion CVP-EVP",681,716,709,0.951117318435754,7,"Jakob Büchler",1104,"Fraktion CVP-EVP"
"105","Jean-François Rime_Fraktion der Schweizerischen Volkspartei",393,661,634,0.594553706505295,27,"Jean-François Rime",1119,"Fraktion der Schweizerischen Volkspartei"
"106","Jean-François Steiert_Sozialdemokratische Fraktion",553,657,629,0.841704718417047,28,"Jean-François Steiert",3865,"Sozialdemokratische Fraktion"
"107","Jean-Paul Gschwind_Fraktion CVP-EVP",713,749,737,0.951935914552737,12,"Jean-Paul Gschwind",4087,"Fraktion CVP-EVP"
"108","Jean-Pierre Graber_Fraktion der Schweizerischen Volkspartei",90,149,144,0.604026845637584,5,"Jean-Pierre Graber",3884,"Fraktion der Schweizerischen Volkspartei"
"109","Jean-Pierre Grin_Fraktion der Schweizerischen Volkspartei",502,752,695,0.667553191489362,57,"Jean-Pierre Grin",3885,"Fraktion der Schweizerischen Volkspartei"
"110","Jean-René Germanier_FDP-Liberale Fraktion",636,682,673,0.932551319648094,9,"Jean-René Germanier",1117,"FDP-Liberale Fraktion"
"111","Jean Christophe Schwaab_Sozialdemokratische Fraktion",610,729,697,0.836762688614541,32,"Jean Christophe Schwaab",4115,"Sozialdemokratische Fraktion"
"112","Josiane Aubert_Sozialdemokratische Fraktion",377,456,433,0.826754385964912,23,"Josiane Aubert",3833,"Sozialdemokratische Fraktion"
"113","Josias F. Gasser_Grünliberale Fraktion",656,706,700,0.929178470254957,6,"Josias F. Gasser",4104,"Grünliberale Fraktion"
"114","Jürg Grossen_Grünliberale Fraktion",665,715,712,0.93006993006993,3,"Jürg Grossen",4083,"Grünliberale Fraktion"
"115","Jürg Stahl_Fraktion der Schweizerischen Volkspartei",426,721,695,0.590846047156727,26,"Jürg Stahl",514,"Fraktion der Schweizerischen Volkspartei"
"116","Karl Vogler_Fraktion CVP-EVP",721,738,731,0.976964769647697,7,"Karl Vogler",4085,"Fraktion CVP-EVP"
"117","Kathrin Bertschy_Grünliberale Fraktion",612,665,659,0.920300751879699,6,"Kathrin Bertschy",4102,"Grünliberale Fraktion"
"118","Kathy Riklin_Fraktion CVP-EVP",700,723,713,0.968188105117566,10,"Kathy Riklin",502,"Fraktion CVP-EVP"
"119","Kurt Fluri_FDP-Liberale Fraktion",637,686,681,0.928571428571429,5,"Kurt Fluri",1122,"FDP-Liberale Fraktion"
"120","Laurent Favre_FDP-Liberale Fraktion",525,555,547,0.945945945945946,8,"Laurent Favre",3922,"FDP-Liberale Fraktion"
"121","Leo Müller_Fraktion CVP-EVP",664,694,689,0.956772334293948,5,"Leo Müller",4097,"Fraktion CVP-EVP"
"122","Lorenz Hess_Fraktion BD",615,636,628,0.966981132075472,8,"Lorenz Hess",4094,"Fraktion BD"
"123","Lorenzo Quadri_Fraktion der Schweizerischen Volkspartei",344,647,595,0.531684698608965,52,"Lorenzo Quadri",4046,"Fraktion der Schweizerischen Volkspartei"
"124","Lothar Ziörjen_Fraktion BD",511,526,524,0.97148288973384,2,"Lothar Ziörjen",4105,"Fraktion BD"
"125","Louis Schelbert_Grüne Fraktion",604,752,698,0.803191489361702,54,"Louis Schelbert",1318,"Grüne Fraktion"
"126","Luc Barthassat_Fraktion CVP-EVP",350,359,357,0.974930362116992,2,"Luc Barthassat",1289,"Fraktion CVP-EVP"
"127","Lucrezia Meier-Schatz_Fraktion CVP-EVP",673,702,688,0.958689458689459,14,"Lucrezia Meier-Schatz",494,"Fraktion CVP-EVP"
"128","Lukas Reimann_Fraktion der Schweizerischen Volkspartei",329,717,708,0.458856345885635,9,"Lukas Reimann",3901,"Fraktion der Schweizerischen Volkspartei"
"129","Luzi Stamm_Fraktion der Schweizerischen Volkspartei",317,632,600,0.501582278481013,32,"Luzi Stamm",214,"Fraktion der Schweizerischen Volkspartei"
"130","Maja Ingold_Fraktion CVP-EVP",681,733,715,0.929058663028649,18,"Maja Ingold",4031,"Fraktion CVP-EVP"
"131","Manuel Tornare_Sozialdemokratische Fraktion",605,714,689,0.84733893557423,25,"Manuel Tornare",4113,"Sozialdemokratische Fraktion"
"132","Marco Romano_Fraktion CVP-EVP",704,741,733,0.950067476383266,8,"Marco Romano",4120,"Fraktion CVP-EVP"
"133","Margret Kiener Nellen_Sozialdemokratische Fraktion",552,693,646,0.796536796536797,47,"Margret Kiener Nellen",1147,"Sozialdemokratische Fraktion"
"134","Margrit Kessler_Grünliberale Fraktion",692,747,742,0.926372155287818,5,"Margrit Kessler",4081,"Grünliberale Fraktion"
"135","Maria Bernasconi_Sozialdemokratische Fraktion",570,691,649,0.824891461649783,42,"Maria Bernasconi",350,"Sozialdemokratische Fraktion"
"136","Marianne Streiff-Feller_Fraktion CVP-EVP",650,701,682,0.927246790299572,19,"Marianne Streiff-Feller",4036,"Fraktion CVP-EVP"
"137","Marina Carobbio Guscetti_Sozialdemokratische Fraktion",613,751,707,0.81624500665779,44,"Marina Carobbio Guscetti",3830,"Sozialdemokratische Fraktion"
"138","Markus Hausammann_Fraktion der Schweizerischen Volkspartei",432,739,655,0.584573748308525,84,"Markus Hausammann",4103,"Fraktion der Schweizerischen Volkspartei"
"139","Markus Hutter_FDP-Liberale Fraktion",323,389,375,0.830334190231362,14,"Markus Hutter",1126,"FDP-Liberale Fraktion"
"140","Markus Lehmann_Fraktion CVP-EVP",654,690,675,0.947826086956522,15,"Markus Lehmann",4099,"Fraktion CVP-EVP"
"141","Markus Ritter_Fraktion CVP-EVP",695,720,715,0.965277777777778,5,"Markus Ritter",4052,"Fraktion CVP-EVP"
"142","Martin Bäumle_Grünliberale Fraktion",544,593,589,0.917369308600337,4,"Martin Bäumle",1138,"Grünliberale Fraktion"
"143","Martin Candinas_Fraktion CVP-EVP",709,737,729,0.962008141112619,8,"Martin Candinas",4070,"Fraktion CVP-EVP"
"144","Martin Landolt_Fraktion BD",590,608,600,0.970394736842105,8,"Martin Landolt",4008,"Fraktion BD"
"145","Martin Naef_Sozialdemokratische Fraktion",566,663,635,0.85369532428356,28,"Martin Naef",4106,"Sozialdemokratische Fraktion"
"146","Martina Munz_Sozialdemokratische Fraktion",332,393,378,0.844783715012723,15,"Martina Munz",4134,"Sozialdemokratische Fraktion"
"147","Mathias Reynard_Sozialdemokratische Fraktion",587,709,670,0.827926657263752,39,"Mathias Reynard",4091,"Sozialdemokratische Fraktion"
"148","Matthias Aebischer_Sozialdemokratische Fraktion",638,739,713,0.863328822733424,26,"Matthias Aebischer",4049,"Sozialdemokratische Fraktion"
"149","Mauro Poggia_Fraktionslos",291,369,340,0.788617886178862,29,"Mauro Poggia",4092,"Fraktionslos"
"150","Max Binder_Fraktion der Schweizerischen Volkspartei",392,715,675,0.548251748251748,40,"Max Binder",15,"Fraktion der Schweizerischen Volkspartei"
"151","Max Chopard-Acklin_Sozialdemokratische Fraktion",622,742,700,0.838274932614555,42,"Max Chopard-Acklin",4007,"Sozialdemokratische Fraktion"
"152","Maximilian Reimann_Fraktion der Schweizerischen Volkspartei",421,687,643,0.612809315866084,44,"Maximilian Reimann",173,"Fraktion der Schweizerischen Volkspartei"
"153","Maya Graf_Grüne Fraktion",475,573,537,0.828970331588133,36,"Maya Graf",806,"Grüne Fraktion"
"154","Nadine Masshardt_Sozialdemokratische Fraktion",415,488,475,0.850409836065574,13,"Nadine Masshardt",4130,"Sozialdemokratische Fraktion"
"155","Nadja Pieren_Fraktion der Schweizerischen Volkspartei",379,758,739,0.5,19,"Nadja Pieren",4065,"Fraktion der Schweizerischen Volkspartei"
"156","Natalie Rickli_Fraktion der Schweizerischen Volkspartei",335,641,608,0.522620904836194,33,"Natalie Rickli",3902,"Fraktion der Schweizerischen Volkspartei"
"157","Olivier Feller_FDP-Liberale Fraktion",691,740,725,0.933783783783784,15,"Olivier Feller",4077,"FDP-Liberale Fraktion"
"158","Olivier Français_FDP-Liberale Fraktion",621,656,653,0.946646341463415,3,"Olivier Français",3879,"FDP-Liberale Fraktion"
"159","Oskar Freysinger_Fraktion der Schweizerischen Volkspartei",363,632,602,0.574367088607595,30,"Oskar Freysinger",1127,"Fraktion der Schweizerischen Volkspartei"
"160","Otto Ineichen_FDP-Liberale Fraktion",88,92,92,0.956521739130435,0,"Otto Ineichen",1118,"FDP-Liberale Fraktion"
"161","Paul Rechsteiner_Sozialdemokratische Fraktion",4,4,4,1,0,"Paul Rechsteiner",172,"Sozialdemokratische Fraktion"
"162","Peter Keller_Fraktion der Schweizerischen Volkspartei",408,730,682,0.558904109589041,48,"Peter Keller",4098,"Fraktion der Schweizerischen Volkspartei"
"163","Peter Malama_FDP-Liberale Fraktion",79,82,80,0.963414634146341,2,"Peter Malama",3896,"FDP-Liberale Fraktion"
"164","Peter Schilliger_FDP-Liberale Fraktion",519,572,571,0.907342657342657,1,"Peter Schilliger",4124,"FDP-Liberale Fraktion"
"165","Peter Spuhler_Fraktion der Schweizerischen Volkspartei",136,202,197,0.673267326732673,5,"Peter Spuhler",513,"Fraktion der Schweizerischen Volkspartei"
"166","Petra Gössi_FDP-Liberale Fraktion",634,738,720,0.859078590785908,18,"Petra Gössi",4116,"FDP-Liberale Fraktion"
"167","Philipp Hadorn_Sozialdemokratische Fraktion",621,753,714,0.824701195219124,39,"Philipp Hadorn",4076,"Sozialdemokratische Fraktion"
"168","Philipp Müller_FDP-Liberale Fraktion",617,700,686,0.881428571428571,14,"Philipp Müller",1141,"FDP-Liberale Fraktion"
"169","Pierre-Alain Fridez_Sozialdemokratische Fraktion",614,737,694,0.833107191316147,43,"Pierre-Alain Fridez",4074,"Sozialdemokratische Fraktion"
"170","Pierre-André Monnard_FDP-Liberale Fraktion",118,127,127,0.929133858267717,0,"Pierre-André Monnard",4147,"FDP-Liberale Fraktion"
"171","Pierre-François Veillon_Fraktion der Schweizerischen Volkspartei",412,600,580,0.686666666666667,20,"Pierre-François Veillon",1123,"Fraktion der Schweizerischen Volkspartei"
"172","Pierre Rusconi_Fraktion der Schweizerischen Volkspartei",407,698,669,0.583094555873925,29,"Pierre Rusconi",4048,"Fraktion der Schweizerischen Volkspartei"
"173","Pirmin Bischof_Fraktion CVP-EVP",4,4,4,1,0,"Pirmin Bischof",3871,"Fraktion CVP-EVP"
"174","Pirmin Schwander_Fraktion der Schweizerischen Volkspartei",307,736,731,0.417119565217391,5,"Pirmin Schwander",1159,"Fraktion der Schweizerischen Volkspartei"
"175","Prisca Birrer-Heimo_Sozialdemokratische Fraktion",610,722,687,0.844875346260388,35,"Prisca Birrer-Heimo",4030,"Sozialdemokratische Fraktion"
"176","Raymond Clottu_Fraktion der Schweizerischen Volkspartei",232,394,383,0.588832487309645,11,"Raymond Clottu",4135,"Fraktion der Schweizerischen Volkspartei"
"177","Rebecca Ana Ruiz_Sozialdemokratische Fraktion",261,293,285,0.890784982935154,8,"Rebecca Ana Ruiz",4143,"Sozialdemokratische Fraktion"
"178","Regula Rytz_Grüne Fraktion",557,699,643,0.796852646638054,56,"Regula Rytz",4095,"Grüne Fraktion"
"179","Roberta Pantani_Fraktion der Schweizerischen Volkspartei",436,705,672,0.618439716312057,33,"Roberta Pantani",4073,"Fraktion der Schweizerischen Volkspartei"
"180","Roger Golay_Fraktion der Schweizerischen Volkspartei",204,344,335,0.593023255813954,9,"Roger Golay",4137,"Fraktion der Schweizerischen Volkspartei"
"181","Roger Golay_Fraktionslos",4,6,5,0.666666666666667,1,"Roger Golay",4137,"Fraktionslos"
"182","Roger Nordmann_Sozialdemokratische Fraktion",608,717,686,0.847977684797768,31,"Roger Nordmann",1279,"Sozialdemokratische Fraktion"
"183","Roland F. Borer_Fraktion der Schweizerischen Volkspartei",362,671,634,0.539493293591654,37,"Roland F. Borer",26,"Fraktion der Schweizerischen Volkspartei"
"184","Roland Fischer_Grünliberale Fraktion",681,734,730,0.927792915531335,4,"Roland Fischer",4089,"Grünliberale Fraktion"
"185","Roland Rino Büchel_Fraktion der Schweizerischen Volkspartei",386,753,667,0.51261620185923,86,"Roland Rino Büchel",4025,"Fraktion der Schweizerischen Volkspartei"
"186","Rosmarie Quadranti_Fraktion BD",711,729,724,0.975308641975309,5,"Rosmarie Quadranti",4066,"Fraktion BD"
"187","Rudolf Joder_Fraktion der Schweizerischen Volkspartei",451,661,639,0.682299546142209,22,"Rudolf Joder",478,"Fraktion der Schweizerischen Volkspartei"
"188","Rudolf Winkler_Fraktion BD",162,168,165,0.964285714285714,3,"Rudolf Winkler",4148,"Fraktion BD"
"189","Ruedi Lustenberger_Fraktion CVP-EVP",460,523,497,0.879541108986616,26,"Ruedi Lustenberger",490,"Fraktion CVP-EVP"
"190","Ruedi Noser_FDP-Liberale Fraktion",618,683,671,0.904831625183016,12,"Ruedi Noser",1153,"FDP-Liberale Fraktion"
"191","Ruth Humbel_Fraktion CVP-EVP",701,721,716,0.972260748959778,5,"Ruth Humbel",1071,"Fraktion CVP-EVP"
"192","Sebastian Frehner_Fraktion der Schweizerischen Volkspartei",350,683,656,0.512445095168375,27,"Sebastian Frehner",4042,"Fraktion der Schweizerischen Volkspartei"
"193","Silva Semadeni_Sozialdemokratische Fraktion",618,747,704,0.827309236947791,43,"Silva Semadeni",354,"Sozialdemokratische Fraktion"
"194","Silvia Schenker_Sozialdemokratische Fraktion",603,749,700,0.805073431241656,49,"Silvia Schenker",1129,"Sozialdemokratische Fraktion"
"195","Stefan Müller-Altermatt_Fraktion CVP-EVP",689,714,704,0.964985994397759,10,"Stefan Müller-Altermatt",4063,"Fraktion CVP-EVP"
"196","Stéphane Rossini_Sozialdemokratische Fraktion",443,545,509,0.812844036697248,36,"Stéphane Rossini",504,"Sozialdemokratische Fraktion"
"197","Susanne Leutenegger Oberholzer_Sozialdemokratische Fraktion",590,735,688,0.802721088435374,47,"Susanne Leutenegger Oberholzer",487,"Sozialdemokratische Fraktion"
"198","Sylvia Flückiger-Bäni_Fraktion der Schweizerischen Volkspartei",388,725,682,0.535172413793103,43,"Sylvia Flückiger-Bäni",3878,"Fraktion der Schweizerischen Volkspartei"
"199","Sylvie Perrinjaquet_FDP-Liberale Fraktion",368,386,382,0.953367875647668,4,"Sylvie Perrinjaquet",3900,"FDP-Liberale Fraktion"
"200","Thomas Aeschi_Fraktion der Schweizerischen Volkspartei",363,751,692,0.48335552596538,59,"Thomas Aeschi",4053,"Fraktion der Schweizerischen Volkspartei"
"201","Thomas Böhni_Grünliberale Fraktion",663,710,705,0.933802816901408,5,"Thomas Böhni",4050,"Grünliberale Fraktion"
"202","Thomas de Courten_Fraktion der Schweizerischen Volkspartei",365,710,652,0.514084507042254,58,"Thomas de Courten",4051,"Fraktion der Schweizerischen Volkspartei"
"203","Thomas Hardegger_Sozialdemokratische Fraktion",613,728,694,0.842032967032967,34,"Thomas Hardegger",4061,"Sozialdemokratische Fraktion"
"204","Thomas Hurter_Fraktion der Schweizerischen Volkspartei",450,730,675,0.616438356164384,55,"Thomas Hurter",3890,"Fraktion der Schweizerischen Volkspartei"
"205","Thomas Maier_Grünliberale Fraktion",667,725,720,0.92,5,"Thomas Maier",4117,"Grünliberale Fraktion"
"206","Thomas Matter_Fraktion der Schweizerischen Volkspartei",142,290,276,0.489655172413793,14,"Thomas Matter",4144,"Fraktion der Schweizerischen Volkspartei"
"207","Thomas Müller_Fraktion der Schweizerischen Volkspartei",445,720,696,0.618055555555556,24,"Thomas Müller",1345,"Fraktion der Schweizerischen Volkspartei"
"208","Thomas Weibel_Grünliberale Fraktion",687,743,735,0.924629878869448,8,"Thomas Weibel",3931,"Grünliberale Fraktion"
"209","Tiana Angelina Moser_Grünliberale Fraktion",636,684,682,0.929824561403509,2,"Tiana Angelina Moser",3897,"Grünliberale Fraktion"
"210","Toni Bortoluzzi_Fraktion der Schweizerischen Volkspartei",308,662,645,0.465256797583082,17,"Toni Bortoluzzi",28,"Fraktion der Schweizerischen Volkspartei"
"211","Toni Brunner_Fraktion der Schweizerischen Volkspartei",343,706,672,0.485835694050992,34,"Toni Brunner",307,"Fraktion der Schweizerischen Volkspartei"
"212","Ueli Leuenberger_Grüne Fraktion",570,708,661,0.805084745762712,47,"Ueli Leuenberger",1065,"Grüne Fraktion"
"213","Ulrich Giezendanner_Fraktion der Schweizerischen Volkspartei",398,659,653,0.603945371775417,6,"Ulrich Giezendanner",91,"Fraktion der Schweizerischen Volkspartei"
"214","Urs Gasche_Fraktion BD",645,677,663,0.952732644017725,14,"Urs Gasche",4071,"Fraktion BD"
"215","Urs Schläfli_Fraktion CVP-EVP",725,750,742,0.966666666666667,8,"Urs Schläfli",4122,"Fraktion CVP-EVP"
"216","Ursula Haller Vannini_Fraktion BD",519,532,528,0.975563909774436,4,"Ursula Haller Vannini",472,"Fraktion BD"
"217","Ursula Schneider Schüttel_Sozialdemokratische Fraktion",532,629,604,0.845786963434022,25,"Ursula Schneider Schüttel",4123,"Sozialdemokratische Fraktion"
"218","Ursula Wyss_Sozialdemokratische Fraktion",170,199,186,0.85427135678392,13,"Ursula Wyss",522,"Sozialdemokratische Fraktion"
"219","Valérie Piller Carrard_Sozialdemokratische Fraktion",606,705,682,0.859574468085106,23,"Valérie Piller Carrard",4109,"Sozialdemokratische Fraktion"
"220","Verena Herzog_Fraktion der Schweizerischen Volkspartei",276,490,471,0.563265306122449,19,"Verena Herzog",4129,"Fraktion der Schweizerischen Volkspartei"
"221","Viola Amherd_Fraktion CVP-EVP",711,734,726,0.96866485013624,8,"Viola Amherd",1288,"Fraktion CVP-EVP"
"222","Walter Müller_FDP-Liberale Fraktion",610,699,678,0.872675250357654,21,"Walter Müller",1137,"FDP-Liberale Fraktion"
"223","Walter Wobmann_Fraktion der Schweizerischen Volkspartei",365,745,726,0.48993288590604,19,"Walter Wobmann",1142,"Fraktion der Schweizerischen Volkspartei"
"224","Yannick Buttet_Fraktion CVP-EVP",682,719,707,0.948539638386648,12,"Yannick Buttet",4086,"Fraktion CVP-EVP"
"225","Yvan Perrin_Fraktion der Schweizerischen Volkspartei",230,350,336,0.657142857142857,14,"Yvan Perrin",1145,"Fraktion der Schweizerischen Volkspartei"
"226","Yves Nidegger_Fraktion der Schweizerischen Volkspartei",370,704,637,0.525568181818182,67,"Yves Nidegger",3898,"Fraktion der Schweizerischen Volkspartei"
"227","Yvette Estermann_Fraktion der Schweizerischen Volkspartei",391,755,724,0.517880794701987,31,"Yvette Estermann",3876,"Fraktion der Schweizerischen Volkspartei"
"228","Yvonne Feri_Sozialdemokratische Fraktion",606,741,695,0.817813765182186,46,"Yvonne Feri",4069,"Sozialdemokratische Fraktion"
"229","Yvonne Gilli_Grüne Fraktion",558,682,634,0.818181818181818,48,"Yvonne Gilli",3881,"Grüne Fraktion"
