"","ident","Successes","anwesend","valid","Sucess_share","enthaltung","Name","PersonNumber","ParlGroupName"
"1","Ada Marra_Sozialdemokratische Fraktion",2543,4369,4263,0.582055390249485,106,"Ada Marra",3923,"Sozialdemokratische Fraktion"
"2","Adèle Thorens Goumaz_Grüne Fraktion",2417,4118,3995,0.586935405536668,123,"Adèle Thorens Goumaz",3907,"Grüne Fraktion"
"3","Adrian Amstutz_Fraktion der Schweizerischen Volkspartei",2404,4132,4056,0.581800580832527,76,"Adrian Amstutz",1135,"Fraktion der Schweizerischen Volkspartei"
"4","Alain Ribaux_FDP-Liberale Fraktion",1534,1830,1816,0.838251366120219,14,"Alain Ribaux",4111,"FDP-Liberale Fraktion"
"5","Albert Rösti_Fraktion der Schweizerischen Volkspartei",2522,4201,4143,0.600333253987146,58,"Albert Rösti",4100,"Fraktion der Schweizerischen Volkspartei"
"6","Albert Vitali_FDP-Liberale Fraktion",3512,4324,4293,0.812210915818686,31,"Albert Vitali",4054,"FDP-Liberale Fraktion"
"7","Alec von Graffenried_Grüne Fraktion",2082,3355,3258,0.620566318926975,97,"Alec von Graffenried",3908,"Grüne Fraktion"
"8","Alexander Tschäppät_Sozialdemokratische Fraktion",2316,3891,3806,0.595219737856592,85,"Alexander Tschäppät",224,"Sozialdemokratische Fraktion"
"9","Alfred Heer_Fraktion der Schweizerischen Volkspartei",1972,3476,3407,0.567318757192175,69,"Alfred Heer",3887,"Fraktion der Schweizerischen Volkspartei"
"10","Aline Trede_Grüne Fraktion",1625,2940,2802,0.552721088435374,138,"Aline Trede",4128,"Grüne Fraktion"
"11","Alois Gmür_Fraktion CVP-EVP",3580,4223,4179,0.847738574473123,44,"Alois Gmür",4096,"Fraktion CVP-EVP"
"12","André Bugnon_Fraktion der Schweizerischen Volkspartei",2414,3975,3898,0.607295597484277,77,"André Bugnon",453,"Fraktion der Schweizerischen Volkspartei"
"13","Andrea Caroni_FDP-Liberale Fraktion",3200,4207,4014,0.760637033515569,193,"Andrea Caroni",4075,"FDP-Liberale Fraktion"
"14","Andrea Martina Geissbühler_Fraktion der Schweizerischen Volkspartei",2277,3928,3802,0.579684317718941,126,"Andrea Martina Geissbühler",3880,"Fraktion der Schweizerischen Volkspartei"
"15","Andreas Aebi_Fraktion der Schweizerischen Volkspartei",2514,4070,3939,0.617690417690418,131,"Andreas Aebi",3867,"Fraktion der Schweizerischen Volkspartei"
"16","Andreas Gross_Sozialdemokratische Fraktion",1577,2780,2655,0.56726618705036,125,"Andreas Gross",97,"Sozialdemokratische Fraktion"
"17","Andy Tschümperlin_Sozialdemokratische Fraktion",2608,4430,4384,0.588713318284424,46,"Andy Tschümperlin",3829,"Sozialdemokratische Fraktion"
"18","Anne Mahrer_Grüne Fraktion",1274,2157,2128,0.590635141400093,29,"Anne Mahrer",4136,"Grüne Fraktion"
"19","Antonio Hodgers_Grüne Fraktion",1127,1957,1901,0.575881451200818,56,"Antonio Hodgers",3889,"Grüne Fraktion"
"20","Balthasar Glättli_Grüne Fraktion",2533,4407,4287,0.57476741547538,120,"Balthasar Glättli",4093,"Grüne Fraktion"
"21","Barbara Gysi_Sozialdemokratische Fraktion",2505,4320,4217,0.579861111111111,103,"Barbara Gysi",4121,"Sozialdemokratische Fraktion"
"22","Barbara Schmid-Federer_Fraktion CVP-EVP",3067,3899,3640,0.786611951782508,259,"Barbara Schmid-Federer",3904,"Fraktion CVP-EVP"
"23","Bastien Girod_Grüne Fraktion",2421,4146,4013,0.583936324167873,133,"Bastien Girod",3882,"Grüne Fraktion"
"24","Bea Heim_Sozialdemokratische Fraktion",2518,4435,4223,0.567756482525366,212,"Bea Heim",1156,"Sozialdemokratische Fraktion"
"25","Beat Flach_Grünliberale Fraktion",3349,4332,4281,0.773084025854109,51,"Beat Flach",4059,"Grünliberale Fraktion"
"26","Beat Jans_Sozialdemokratische Fraktion",2590,4416,4327,0.586503623188406,89,"Beat Jans",4032,"Sozialdemokratische Fraktion"
"27","Beat Walti_FDP-Liberale Fraktion",1257,1576,1536,0.79758883248731,40,"Beat Walti",4142,"FDP-Liberale Fraktion"
"28","Bernhard Guhl_Fraktion BD",3695,4382,4303,0.843222272934733,79,"Bernhard Guhl",4082,"Fraktion BD"
"29","Bruno Pezzatti_FDP-Liberale Fraktion",3087,4101,3952,0.752743233357718,149,"Bruno Pezzatti",4084,"FDP-Liberale Fraktion"
"30","Bruno Zuppiger_Fraktion der Schweizerischen Volkspartei",428,771,736,0.555123216601816,35,"Bruno Zuppiger",526,"Fraktion der Schweizerischen Volkspartei"
"31","Carlo Sommaruga_Sozialdemokratische Fraktion",2277,3930,3810,0.579389312977099,120,"Carlo Sommaruga",1120,"Sozialdemokratische Fraktion"
"32","Caspar Baader_Fraktion der Schweizerischen Volkspartei",1568,2703,2628,0.580096189419164,75,"Caspar Baader",404,"Fraktion der Schweizerischen Volkspartei"
"33","Cédric Wermuth_Sozialdemokratische Fraktion",2417,4155,4033,0.581708784596871,122,"Cédric Wermuth",4057,"Sozialdemokratische Fraktion"
"34","Céline Amaudruz_Fraktion der Schweizerischen Volkspartei",2638,4341,4263,0.607694079705137,78,"Céline Amaudruz",4090,"Fraktion der Schweizerischen Volkspartei"
"35","Cesla Amarelle_Sozialdemokratische Fraktion",2488,4278,4181,0.581580177653109,97,"Cesla Amarelle",4107,"Sozialdemokratische Fraktion"
"36","Chantal Galladé_Sozialdemokratische Fraktion",2301,3776,3715,0.609375,61,"Chantal Galladé",1125,"Sozialdemokratische Fraktion"
"37","Christa Markwalder_FDP-Liberale Fraktion",3463,4258,4129,0.813292625645843,129,"Christa Markwalder",1139,"FDP-Liberale Fraktion"
"38","Christian Levrat_Sozialdemokratische Fraktion",362,565,553,0.64070796460177,12,"Christian Levrat",1150,"Sozialdemokratische Fraktion"
"39","Christian Lohr_Fraktion CVP-EVP",3483,4148,4052,0.839681774349084,96,"Christian Lohr",4118,"Fraktion CVP-EVP"
"40","Christian Lüscher_FDP-Liberale Fraktion",3335,4137,4000,0.806139714769156,137,"Christian Lüscher",3895,"FDP-Liberale Fraktion"
"41","Christian Miesch_Fraktion der Schweizerischen Volkspartei",795,1507,1504,0.527538155275382,3,"Christian Miesch",151,"Fraktion der Schweizerischen Volkspartei"
"42","Christian van Singer_Grüne Fraktion",2539,4394,4142,0.577833409194356,252,"Christian van Singer",3924,"Grüne Fraktion"
"43","Christian Wasserfallen_FDP-Liberale Fraktion",3290,4340,4156,0.758064516129032,184,"Christian Wasserfallen",3912,"FDP-Liberale Fraktion"
"44","Christine Bulliard-Marbach_Fraktion CVP-EVP",3569,4136,4106,0.862911025145068,30,"Christine Bulliard-Marbach",4101,"Fraktion CVP-EVP"
"45","Christine Häsler_Grüne Fraktion",298,512,503,0.58203125,9,"Christine Häsler",4149,"Grüne Fraktion"
"46","Christoph Blocher_Fraktion der Schweizerischen Volkspartei",971,1787,1733,0.543368774482373,54,"Christoph Blocher",21,"Fraktion der Schweizerischen Volkspartei"
"47","Christoph Mörgeli_Fraktion der Schweizerischen Volkspartei",2069,3647,3595,0.567315601864546,52,"Christoph Mörgeli",542,"Fraktion der Schweizerischen Volkspartei"
"48","Christophe Darbellay_Fraktion CVP-EVP",3175,3684,3632,0.861834961997828,52,"Christophe Darbellay",1133,"Fraktion CVP-EVP"
"49","Claudia Friedl_Sozialdemokratische Fraktion",1789,3058,3001,0.585022890778287,57,"Claudia Friedl",4131,"Sozialdemokratische Fraktion"
"50","Corina Eichenberger-Walther_FDP-Liberale Fraktion",3379,4212,4138,0.802231718898386,74,"Corina Eichenberger-Walther",3875,"FDP-Liberale Fraktion"
"51","Corrado Pardini_Sozialdemokratische Fraktion",2380,4060,3974,0.586206896551724,86,"Corrado Pardini",4045,"Sozialdemokratische Fraktion"
"52","Daniel Fässler_Fraktion CVP-EVP",2801,3585,3356,0.781311018131102,229,"Daniel Fässler",4056,"Fraktion CVP-EVP"
"53","Daniel Jositsch_Sozialdemokratische Fraktion",2334,3807,3745,0.613081166272656,62,"Daniel Jositsch",3891,"Sozialdemokratische Fraktion"
"54","Daniel Stolz_FDP-Liberale Fraktion",2453,3122,3004,0.785714285714286,118,"Daniel Stolz",4126,"FDP-Liberale Fraktion"
"55","Daniel Vischer_Grüne Fraktion",2384,4252,4045,0.560677328316087,207,"Daniel Vischer",1110,"Grüne Fraktion"
"56","Daniela Schneeberger_FDP-Liberale Fraktion",3579,4476,4458,0.799597855227882,18,"Daniela Schneeberger",4060,"FDP-Liberale Fraktion"
"57","Dominique de Buman_Fraktion CVP-EVP",3589,4354,4216,0.824299494717501,138,"Dominique de Buman",1124,"Fraktion CVP-EVP"
"58","Doris Fiala_FDP-Liberale Fraktion",3301,4181,4060,0.789524037311648,121,"Doris Fiala",3877,"FDP-Liberale Fraktion"
"59","Edith Graf-Litscher_Sozialdemokratische Fraktion",2610,4354,4303,0.599448782728526,51,"Edith Graf-Litscher",1295,"Sozialdemokratische Fraktion"
"60","Elisabeth Schneider-Schneiter_Fraktion CVP-EVP",3815,4335,4271,0.880046136101499,64,"Elisabeth Schneider-Schneiter",4040,"Fraktion CVP-EVP"
"61","Eric Nussbaumer_Sozialdemokratische Fraktion",2469,4179,4081,0.5908111988514,98,"Eric Nussbaumer",3899,"Sozialdemokratische Fraktion"
"62","Eric Voruz_Sozialdemokratische Fraktion",2197,3774,3656,0.582140964493906,118,"Eric Voruz",3911,"Sozialdemokratische Fraktion"
"63","Erich von Siebenthal_Fraktion der Schweizerischen Volkspartei",2521,4255,4135,0.592479435957697,120,"Erich von Siebenthal",3910,"Fraktion der Schweizerischen Volkspartei"
"64","Ernst Schibli_Fraktion der Schweizerischen Volkspartei",1000,1817,1806,0.550357732526142,11,"Ernst Schibli",820,"Fraktion der Schweizerischen Volkspartei"
"65","Evi Allemann_Sozialdemokratische Fraktion",2565,4295,4237,0.59720605355064,58,"Evi Allemann",1131,"Sozialdemokratische Fraktion"
"66","Fabio Regazzi_Fraktion CVP-EVP",3643,4446,4227,0.819388214125056,219,"Fabio Regazzi",4072,"Fraktion CVP-EVP"
"67","Fathi Derder_FDP-Liberale Fraktion",3344,4045,3951,0.826699629171817,94,"Fathi Derder",4079,"FDP-Liberale Fraktion"
"68","Felix Müri_Fraktion der Schweizerischen Volkspartei",2533,4379,4328,0.578442566796072,51,"Felix Müri",1111,"Fraktion der Schweizerischen Volkspartei"
"69","Filippo Leutenegger_FDP-Liberale Fraktion",1323,1902,1734,0.695583596214511,168,"Filippo Leutenegger",1113,"FDP-Liberale Fraktion"
"70","Francine John-Calame_Grüne Fraktion",2554,4424,4314,0.577305605786618,110,"Francine John-Calame",1293,"Grüne Fraktion"
"71","Franziska Teuscher_Grüne Fraktion",826,1415,1385,0.583745583038869,30,"Franziska Teuscher",359,"Grüne Fraktion"
"72","Fulvio Pelli_FDP-Liberale Fraktion",1482,1859,1837,0.797202797202797,22,"Fulvio Pelli",345,"FDP-Liberale Fraktion"
"73","Gabi Huber_FDP-Liberale Fraktion",3564,4477,4411,0.796068796068796,66,"Gabi Huber",1103,"FDP-Liberale Fraktion"
"74","Gerhard Pfister_Fraktion CVP-EVP",3066,4015,3817,0.763636363636364,198,"Gerhard Pfister",1109,"Fraktion CVP-EVP"
"75","Geri Müller_Grüne Fraktion",2208,3763,3678,0.586765878288599,85,"Geri Müller",1112,"Grüne Fraktion"
"76","Giovanni Merlini_FDP-Liberale Fraktion",1657,1986,1968,0.834340382678751,18,"Giovanni Merlini",4140,"FDP-Liberale Fraktion"
"77","Gregor Rutz_Fraktion der Schweizerischen Volkspartei",1669,3038,2967,0.549374588545095,71,"Gregor Rutz",4125,"Fraktion der Schweizerischen Volkspartei"
"78","Guillaume Barazzone_Fraktion CVP-EVP",1529,1808,1729,0.845685840707965,79,"Guillaume Barazzone",4138,"Fraktion CVP-EVP"
"79","Guy Parmelin_Fraktion der Schweizerischen Volkspartei",2727,4497,4324,0.606404269513009,173,"Guy Parmelin",1108,"Fraktion der Schweizerischen Volkspartei"
"80","Hans-Jürg Fehr_Sozialdemokratische Fraktion",1037,1772,1743,0.585214446952596,29,"Hans-Jürg Fehr",464,"Sozialdemokratische Fraktion"
"81","Hans-Peter Portmann_FDP-Liberale Fraktion",1300,1730,1723,0.751445086705202,7,"Hans-Peter Portmann",4141,"FDP-Liberale Fraktion"
"82","Hans Egloff_Fraktion der Schweizerischen Volkspartei",2289,3951,3894,0.579347000759301,57,"Hans Egloff",4110,"Fraktion der Schweizerischen Volkspartei"
"83","Hans Fehr_Fraktion der Schweizerischen Volkspartei",2275,4033,3974,0.564096206298041,59,"Hans Fehr",319,"Fraktion der Schweizerischen Volkspartei"
"84","Hans Grunder_Fraktion BD",2619,3176,3130,0.824622166246851,46,"Hans Grunder",3886,"Fraktion BD"
"85","Hans Kaufmann_Fraktion der Schweizerischen Volkspartei",1430,2448,2386,0.584150326797386,62,"Hans Kaufmann",479,"Fraktion der Schweizerischen Volkspartei"
"86","Hans Killer_Fraktion der Schweizerischen Volkspartei",2612,4393,4350,0.594582290006829,43,"Hans Killer",3892,"Fraktion der Schweizerischen Volkspartei"
"87","Hansjörg Hassler_Fraktion BD",3697,4336,4280,0.852629151291513,56,"Hansjörg Hassler",473,"Fraktion BD"
"88","Hansjörg Knecht_Fraktion der Schweizerischen Volkspartei",2596,4309,4283,0.602459967509863,26,"Hansjörg Knecht",4114,"Fraktion der Schweizerischen Volkspartei"
"89","Hansjörg Walter_Fraktion der Schweizerischen Volkspartei",1933,3133,3085,0.6169805298436,48,"Hansjörg Walter",519,"Fraktion der Schweizerischen Volkspartei"
"90","Hansruedi Wandfluh_Fraktion der Schweizerischen Volkspartei",1878,3098,3056,0.60619754680439,42,"Hansruedi Wandfluh",520,"Fraktion der Schweizerischen Volkspartei"
"91","Heinz Brand_Fraktion der Schweizerischen Volkspartei",2490,4116,4045,0.604956268221574,71,"Heinz Brand",4067,"Fraktion der Schweizerischen Volkspartei"
"92","Heinz Siegenthaler_Fraktion BD",1074,1204,1186,0.89202657807309,18,"Heinz Siegenthaler",4146,"Fraktion BD"
"93","Hildegard Fässler-Osterwalder_Sozialdemokratische Fraktion",853,1434,1408,0.594839609483961,26,"Hildegard Fässler-Osterwalder",395,"Sozialdemokratische Fraktion"
"94","Hugues Hiltpold_FDP-Liberale Fraktion",3644,4415,4375,0.825368063420159,40,"Hugues Hiltpold",3888,"FDP-Liberale Fraktion"
"95","Ida Glanzmann-Hunkeler_Fraktion CVP-EVP",3729,4314,4239,0.864394993045897,75,"Ida Glanzmann-Hunkeler",1337,"Fraktion CVP-EVP"
"96","Ignazio Cassis_FDP-Liberale Fraktion",3476,4332,4220,0.802400738688827,112,"Ignazio Cassis",3828,"FDP-Liberale Fraktion"
"97","Isabelle Chevalley_Grünliberale Fraktion",3115,4041,3941,0.770848799802029,100,"Isabelle Chevalley",4108,"Grünliberale Fraktion"
"98","Isabelle Moret_FDP-Liberale Fraktion",3456,4266,4073,0.810126582278481,193,"Isabelle Moret",1346,"FDP-Liberale Fraktion"
"99","Jacqueline Badran_Sozialdemokratische Fraktion",2357,3906,3816,0.603430619559652,90,"Jacqueline Badran",4058,"Sozialdemokratische Fraktion"
"100","Jacqueline Fehr_Sozialdemokratische Fraktion",2178,3681,3607,0.591687041564792,74,"Jacqueline Fehr",405,"Sozialdemokratische Fraktion"
"101","Jacques-André Maire_Sozialdemokratische Fraktion",2628,4436,4348,0.592425608656447,88,"Jacques-André Maire",4018,"Sozialdemokratische Fraktion"
"102","Jacques Bourgeois_FDP-Liberale Fraktion",3617,4322,4256,0.836881073577048,66,"Jacques Bourgeois",3872,"FDP-Liberale Fraktion"
"103","Jacques Neirynck_Fraktion CVP-EVP",2868,3786,3588,0.757527733755943,198,"Jacques Neirynck",498,"Fraktion CVP-EVP"
"104","Jakob Büchler_Fraktion CVP-EVP",3525,4256,4183,0.828242481203007,73,"Jakob Büchler",1104,"Fraktion CVP-EVP"
"105","Jean-François Rime_Fraktion der Schweizerischen Volkspartei",2332,3923,3862,0.594443028294672,61,"Jean-François Rime",1119,"Fraktion der Schweizerischen Volkspartei"
"106","Jean-François Steiert_Sozialdemokratische Fraktion",2255,3795,3712,0.594202898550725,83,"Jean-François Steiert",3865,"Sozialdemokratische Fraktion"
"107","Jean-Paul Gschwind_Fraktion CVP-EVP",3751,4393,4310,0.853858411108582,83,"Jean-Paul Gschwind",4087,"Fraktion CVP-EVP"
"108","Jean-Pierre Graber_Fraktion der Schweizerischen Volkspartei",547,926,907,0.590712742980562,19,"Jean-Pierre Graber",3884,"Fraktion der Schweizerischen Volkspartei"
"109","Jean-Pierre Grin_Fraktion der Schweizerischen Volkspartei",2788,4478,4336,0.622599374720858,142,"Jean-Pierre Grin",3885,"Fraktion der Schweizerischen Volkspartei"
"110","Jean-René Germanier_FDP-Liberale Fraktion",3197,3855,3734,0.829312581063554,121,"Jean-René Germanier",1117,"FDP-Liberale Fraktion"
"111","Jean Christophe Schwaab_Sozialdemokratische Fraktion",2522,4276,4213,0.589803554724041,63,"Jean Christophe Schwaab",4115,"Sozialdemokratische Fraktion"
"112","Josiane Aubert_Sozialdemokratische Fraktion",1588,2746,2699,0.578295702840495,47,"Josiane Aubert",3833,"Sozialdemokratische Fraktion"
"113","Josias F. Gasser_Grünliberale Fraktion",3271,4238,4169,0.771826333176026,69,"Josias F. Gasser",4104,"Grünliberale Fraktion"
"114","Jürg Grossen_Grünliberale Fraktion",3283,4254,4204,0.771744240714622,50,"Jürg Grossen",4083,"Grünliberale Fraktion"
"115","Jürg Stahl_Fraktion der Schweizerischen Volkspartei",2480,4120,4061,0.601941747572815,59,"Jürg Stahl",514,"Fraktion der Schweizerischen Volkspartei"
"116","Karl Vogler_Fraktion CVP-EVP",3836,4449,4303,0.862216228365925,146,"Karl Vogler",4085,"Fraktion CVP-EVP"
"117","Kathrin Bertschy_Grünliberale Fraktion",2911,3772,3715,0.771739130434783,57,"Kathrin Bertschy",4102,"Grünliberale Fraktion"
"118","Kathy Riklin_Fraktion CVP-EVP",3382,4120,3988,0.820873786407767,132,"Kathy Riklin",502,"Fraktion CVP-EVP"
"119","Kurt Fluri_FDP-Liberale Fraktion",3210,4003,3945,0.801898576067949,58,"Kurt Fluri",1122,"FDP-Liberale Fraktion"
"120","Laurent Favre_FDP-Liberale Fraktion",2738,3324,3230,0.823706377858002,94,"Laurent Favre",3922,"FDP-Liberale Fraktion"
"121","Leo Müller_Fraktion CVP-EVP",3507,4151,4097,0.844856661045531,54,"Leo Müller",4097,"Fraktion CVP-EVP"
"122","Lorenz Hess_Fraktion BD",3293,3872,3820,0.850464876033058,52,"Lorenz Hess",4094,"Fraktion BD"
"123","Lorenzo Quadri_Fraktion der Schweizerischen Volkspartei",2131,3741,3589,0.569633787757284,152,"Lorenzo Quadri",4046,"Fraktion der Schweizerischen Volkspartei"
"124","Lothar Ziörjen_Fraktion BD",2495,2981,2971,0.836967460583697,10,"Lothar Ziörjen",4105,"Fraktion BD"
"125","Louis Schelbert_Grüne Fraktion",2590,4461,4325,0.580587312261825,136,"Louis Schelbert",1318,"Grüne Fraktion"
"126","Luc Barthassat_Fraktion CVP-EVP",1756,2087,2028,0.841399137517968,59,"Luc Barthassat",1289,"Fraktion CVP-EVP"
"127","Lucrezia Meier-Schatz_Fraktion CVP-EVP",3363,4215,4049,0.797864768683274,166,"Lucrezia Meier-Schatz",494,"Fraktion CVP-EVP"
"128","Lukas Reimann_Fraktion der Schweizerischen Volkspartei",2418,4349,4318,0.555989882731662,31,"Lukas Reimann",3901,"Fraktion der Schweizerischen Volkspartei"
"129","Luzi Stamm_Fraktion der Schweizerischen Volkspartei",2170,3801,3740,0.570902394106814,61,"Luzi Stamm",214,"Fraktion der Schweizerischen Volkspartei"
"130","Maja Ingold_Fraktion CVP-EVP",3142,4301,4129,0.730527784236224,172,"Maja Ingold",4031,"Fraktion CVP-EVP"
"131","Manuel Tornare_Sozialdemokratische Fraktion",2563,4332,4272,0.591643582640813,60,"Manuel Tornare",4113,"Sozialdemokratische Fraktion"
"132","Marco Romano_Fraktion CVP-EVP",3734,4422,4362,0.844414292175486,60,"Marco Romano",4120,"Fraktion CVP-EVP"
"133","Margret Kiener Nellen_Sozialdemokratische Fraktion",2376,4186,4078,0.567606306736742,108,"Margret Kiener Nellen",1147,"Sozialdemokratische Fraktion"
"134","Margrit Kessler_Grünliberale Fraktion",3452,4483,4431,0.77002007584207,52,"Margrit Kessler",4081,"Grünliberale Fraktion"
"135","Maria Bernasconi_Sozialdemokratische Fraktion",2329,4029,3890,0.578059071729958,139,"Maria Bernasconi",350,"Sozialdemokratische Fraktion"
"136","Marianne Streiff-Feller_Fraktion CVP-EVP",3071,4250,4101,0.722588235294118,149,"Marianne Streiff-Feller",4036,"Fraktion CVP-EVP"
"137","Marina Carobbio Guscetti_Sozialdemokratische Fraktion",2579,4442,4336,0.580594326879784,106,"Marina Carobbio Guscetti",3830,"Sozialdemokratische Fraktion"
"138","Markus Hausammann_Fraktion der Schweizerischen Volkspartei",2606,4347,4165,0.59949390384173,182,"Markus Hausammann",4103,"Fraktion der Schweizerischen Volkspartei"
"139","Markus Hutter_FDP-Liberale Fraktion",1703,2275,2195,0.748571428571429,80,"Markus Hutter",1126,"FDP-Liberale Fraktion"
"140","Markus Lehmann_Fraktion CVP-EVP",3330,3970,3867,0.838790931989924,103,"Markus Lehmann",4099,"Fraktion CVP-EVP"
"141","Markus Ritter_Fraktion CVP-EVP",3627,4267,4199,0.850011717834544,68,"Markus Ritter",4052,"Fraktion CVP-EVP"
"142","Martin Bäumle_Grünliberale Fraktion",2696,3567,3510,0.755817213344547,57,"Martin Bäumle",1138,"Grünliberale Fraktion"
"143","Martin Candinas_Fraktion CVP-EVP",3702,4375,4281,0.846171428571429,94,"Martin Candinas",4070,"Fraktion CVP-EVP"
"144","Martin Landolt_Fraktion BD",2927,3545,3434,0.825669957686883,111,"Martin Landolt",4008,"Fraktion BD"
"145","Martin Naef_Sozialdemokratische Fraktion",2433,4151,4055,0.586123825584197,96,"Martin Naef",4106,"Sozialdemokratische Fraktion"
"146","Martina Munz_Sozialdemokratische Fraktion",1460,2531,2490,0.576847096009482,41,"Martina Munz",4134,"Sozialdemokratische Fraktion"
"147","Mathias Reynard_Sozialdemokratische Fraktion",2558,4354,4237,0.587505741846578,117,"Mathias Reynard",4091,"Sozialdemokratische Fraktion"
"148","Matthias Aebischer_Sozialdemokratische Fraktion",2641,4427,4361,0.59656652360515,66,"Matthias Aebischer",4049,"Sozialdemokratische Fraktion"
"149","Mauro Poggia_Fraktionslos",1566,2127,2081,0.736248236953456,46,"Mauro Poggia",4092,"Fraktionslos"
"150","Max Binder_Fraktion der Schweizerischen Volkspartei",2434,4154,4074,0.585941261434762,80,"Max Binder",15,"Fraktion der Schweizerischen Volkspartei"
"151","Max Chopard-Acklin_Sozialdemokratische Fraktion",2579,4436,4306,0.581379621280433,130,"Max Chopard-Acklin",4007,"Sozialdemokratische Fraktion"
"152","Maximilian Reimann_Fraktion der Schweizerischen Volkspartei",2426,4069,3969,0.596215286311133,100,"Maximilian Reimann",173,"Fraktion der Schweizerischen Volkspartei"
"153","Maya Graf_Grüne Fraktion",2014,3375,3284,0.596740740740741,91,"Maya Graf",806,"Grüne Fraktion"
"154","Nadine Masshardt_Sozialdemokratische Fraktion",1742,2903,2859,0.60006889424733,44,"Nadine Masshardt",4130,"Sozialdemokratische Fraktion"
"155","Nadja Pieren_Fraktion der Schweizerischen Volkspartei",2612,4520,4460,0.57787610619469,60,"Nadja Pieren",4065,"Fraktion der Schweizerischen Volkspartei"
"156","Natalie Rickli_Fraktion der Schweizerischen Volkspartei",2165,3781,3718,0.572599841311822,63,"Natalie Rickli",3902,"Fraktion der Schweizerischen Volkspartei"
"157","Olivier Feller_FDP-Liberale Fraktion",3494,4253,4098,0.821537738067247,155,"Olivier Feller",4077,"FDP-Liberale Fraktion"
"158","Olivier Français_FDP-Liberale Fraktion",3089,3697,3622,0.835542331620233,75,"Olivier Français",3879,"FDP-Liberale Fraktion"
"159","Oskar Freysinger_Fraktion der Schweizerischen Volkspartei",2074,3403,3355,0.609462239200705,48,"Oskar Freysinger",1127,"Fraktion der Schweizerischen Volkspartei"
"160","Otto Ineichen_FDP-Liberale Fraktion",383,488,478,0.784836065573771,10,"Otto Ineichen",1118,"FDP-Liberale Fraktion"
"161","Paul Rechsteiner_Sozialdemokratische Fraktion",22,39,38,0.564102564102564,1,"Paul Rechsteiner",172,"Sozialdemokratische Fraktion"
"162","Peter Keller_Fraktion der Schweizerischen Volkspartei",2525,4271,4181,0.591196441114493,90,"Peter Keller",4098,"Fraktion der Schweizerischen Volkspartei"
"163","Peter Malama_FDP-Liberale Fraktion",307,376,366,0.816489361702128,10,"Peter Malama",3896,"FDP-Liberale Fraktion"
"164","Peter Schilliger_FDP-Liberale Fraktion",2793,3484,3463,0.80166475315729,21,"Peter Schilliger",4124,"FDP-Liberale Fraktion"
"165","Peter Spuhler_Fraktion der Schweizerischen Volkspartei",518,814,806,0.636363636363636,8,"Peter Spuhler",513,"Fraktion der Schweizerischen Volkspartei"
"166","Petra Gössi_FDP-Liberale Fraktion",3332,4358,4273,0.764570904084442,85,"Petra Gössi",4116,"FDP-Liberale Fraktion"
"167","Philipp Hadorn_Sozialdemokratische Fraktion",2599,4478,4387,0.580393032603841,91,"Philipp Hadorn",4076,"Sozialdemokratische Fraktion"
"168","Philipp Müller_FDP-Liberale Fraktion",3209,4085,4024,0.785556915544676,61,"Philipp Müller",1141,"FDP-Liberale Fraktion"
"169","Pierre-Alain Fridez_Sozialdemokratische Fraktion",2505,4238,4120,0.591080698442662,118,"Pierre-Alain Fridez",4074,"Sozialdemokratische Fraktion"
"170","Pierre-André Monnard_FDP-Liberale Fraktion",616,722,720,0.853185595567867,2,"Pierre-André Monnard",4147,"FDP-Liberale Fraktion"
"171","Pierre-François Veillon_Fraktion der Schweizerischen Volkspartei",2315,3681,3622,0.628905188807389,59,"Pierre-François Veillon",1123,"Fraktion der Schweizerischen Volkspartei"
"172","Pierre Rusconi_Fraktion der Schweizerischen Volkspartei",2438,4081,3984,0.597402597402597,97,"Pierre Rusconi",4048,"Fraktion der Schweizerischen Volkspartei"
"173","Pirmin Bischof_Fraktion CVP-EVP",22,30,28,0.733333333333333,2,"Pirmin Bischof",3871,"Fraktion CVP-EVP"
"174","Pirmin Schwander_Fraktion der Schweizerischen Volkspartei",2314,4295,4278,0.538766006984866,17,"Pirmin Schwander",1159,"Fraktion der Schweizerischen Volkspartei"
"175","Prisca Birrer-Heimo_Sozialdemokratische Fraktion",2537,4305,4201,0.58931475029036,104,"Prisca Birrer-Heimo",4030,"Sozialdemokratische Fraktion"
"176","Raymond Clottu_Fraktion der Schweizerischen Volkspartei",1516,2514,2486,0.6030230708035,28,"Raymond Clottu",4135,"Fraktion der Schweizerischen Volkspartei"
"177","Rebecca Ana Ruiz_Sozialdemokratische Fraktion",1088,1748,1719,0.622425629290618,29,"Rebecca Ana Ruiz",4143,"Sozialdemokratische Fraktion"
"178","Regula Rytz_Grüne Fraktion",2404,4208,4068,0.571292775665399,140,"Regula Rytz",4095,"Grüne Fraktion"
"179","Roberta Pantani_Fraktion der Schweizerischen Volkspartei",2539,4211,4111,0.602944668724768,100,"Roberta Pantani",4073,"Fraktion der Schweizerischen Volkspartei"
"180","Roger Golay_Fraktion der Schweizerischen Volkspartei",1261,2090,2040,0.603349282296651,50,"Roger Golay",4137,"Fraktion der Schweizerischen Volkspartei"
"181","Roger Golay_Fraktionslos",19,34,32,0.558823529411765,2,"Roger Golay",4137,"Fraktionslos"
"182","Roger Nordmann_Sozialdemokratische Fraktion",2582,4319,4252,0.597823570270896,67,"Roger Nordmann",1279,"Sozialdemokratische Fraktion"
"183","Roland F. Borer_Fraktion der Schweizerischen Volkspartei",2311,3971,3892,0.581969277260136,79,"Roland F. Borer",26,"Fraktion der Schweizerischen Volkspartei"
"184","Roland Fischer_Grünliberale Fraktion",3393,4408,4365,0.769736842105263,43,"Roland Fischer",4089,"Grünliberale Fraktion"
"185","Roland Rino Büchel_Fraktion der Schweizerischen Volkspartei",2543,4470,4281,0.568903803131991,189,"Roland Rino Büchel",4025,"Fraktion der Schweizerischen Volkspartei"
"186","Rosmarie Quadranti_Fraktion BD",3714,4436,4368,0.837240757439134,68,"Rosmarie Quadranti",4066,"Fraktion BD"
"187","Rudolf Joder_Fraktion der Schweizerischen Volkspartei",2460,3872,3822,0.635330578512397,50,"Rudolf Joder",478,"Fraktion der Schweizerischen Volkspartei"
"188","Rudolf Winkler_Fraktion BD",875,982,974,0.891038696537678,8,"Rudolf Winkler",4148,"Fraktion BD"
"189","Ruedi Lustenberger_Fraktion CVP-EVP",2596,3310,3175,0.78429003021148,135,"Ruedi Lustenberger",490,"Fraktion CVP-EVP"
"190","Ruedi Noser_FDP-Liberale Fraktion",2997,3820,3707,0.78455497382199,113,"Ruedi Noser",1153,"FDP-Liberale Fraktion"
"191","Ruth Humbel_Fraktion CVP-EVP",3579,4366,4129,0.819743472285845,237,"Ruth Humbel",1071,"Fraktion CVP-EVP"
"192","Sebastian Frehner_Fraktion der Schweizerischen Volkspartei",2144,3743,3696,0.572802564787603,47,"Sebastian Frehner",4042,"Fraktion der Schweizerischen Volkspartei"
"193","Silva Semadeni_Sozialdemokratische Fraktion",2590,4435,4301,0.583990980834273,134,"Silva Semadeni",354,"Sozialdemokratische Fraktion"
"194","Silvia Schenker_Sozialdemokratische Fraktion",2569,4483,4376,0.573053758643765,107,"Silvia Schenker",1129,"Sozialdemokratische Fraktion"
"195","Stefan Müller-Altermatt_Fraktion CVP-EVP",3464,4214,4038,0.822021831988609,176,"Stefan Müller-Altermatt",4063,"Fraktion CVP-EVP"
"196","Stéphane Rossini_Sozialdemokratische Fraktion",1893,3203,3139,0.591008429597253,64,"Stéphane Rossini",504,"Sozialdemokratische Fraktion"
"197","Susanne Leutenegger Oberholzer_Sozialdemokratische Fraktion",2474,4357,4223,0.567821895799862,134,"Susanne Leutenegger Oberholzer",487,"Sozialdemokratische Fraktion"
"198","Sylvia Flückiger-Bäni_Fraktion der Schweizerischen Volkspartei",2543,4382,4305,0.580328617069831,77,"Sylvia Flückiger-Bäni",3878,"Fraktion der Schweizerischen Volkspartei"
"199","Sylvie Perrinjaquet_FDP-Liberale Fraktion",1966,2335,2288,0.841970021413276,47,"Sylvie Perrinjaquet",3900,"FDP-Liberale Fraktion"
"200","Thomas Aeschi_Fraktion der Schweizerischen Volkspartei",2493,4477,4340,0.556846102300648,137,"Thomas Aeschi",4053,"Fraktion der Schweizerischen Volkspartei"
"201","Thomas Böhni_Grünliberale Fraktion",3251,4212,4179,0.771842355175689,33,"Thomas Böhni",4050,"Grünliberale Fraktion"
"202","Thomas de Courten_Fraktion der Schweizerischen Volkspartei",2382,4158,4067,0.572871572871573,91,"Thomas de Courten",4051,"Fraktion der Schweizerischen Volkspartei"
"203","Thomas Hardegger_Sozialdemokratische Fraktion",2549,4325,4244,0.589364161849711,81,"Thomas Hardegger",4061,"Sozialdemokratische Fraktion"
"204","Thomas Hurter_Fraktion der Schweizerischen Volkspartei",2637,4361,4233,0.604677826186654,128,"Thomas Hurter",3890,"Fraktion der Schweizerischen Volkspartei"
"205","Thomas Maier_Grünliberale Fraktion",3246,4259,4199,0.762150739610237,60,"Thomas Maier",4117,"Grünliberale Fraktion"
"206","Thomas Matter_Fraktion der Schweizerischen Volkspartei",934,1716,1684,0.544289044289044,32,"Thomas Matter",4144,"Fraktion der Schweizerischen Volkspartei"
"207","Thomas Müller_Fraktion der Schweizerischen Volkspartei",2473,4054,3992,0.610014800197336,62,"Thomas Müller",1345,"Fraktion der Schweizerischen Volkspartei"
"208","Thomas Weibel_Grünliberale Fraktion",3388,4422,4346,0.766169154228856,76,"Thomas Weibel",3931,"Grünliberale Fraktion"
"209","Tiana Angelina Moser_Grünliberale Fraktion",3124,4028,3996,0.775571002979146,32,"Tiana Angelina Moser",3897,"Grünliberale Fraktion"
"210","Toni Bortoluzzi_Fraktion der Schweizerischen Volkspartei",2262,4000,3956,0.5655,44,"Toni Bortoluzzi",28,"Fraktion der Schweizerischen Volkspartei"
"211","Toni Brunner_Fraktion der Schweizerischen Volkspartei",2368,4169,4093,0.568001918925402,76,"Toni Brunner",307,"Fraktion der Schweizerischen Volkspartei"
"212","Ueli Leuenberger_Grüne Fraktion",2487,4292,4160,0.579450139794967,132,"Ueli Leuenberger",1065,"Grüne Fraktion"
"213","Ulrich Giezendanner_Fraktion der Schweizerischen Volkspartei",2278,3815,3784,0.597116644823067,31,"Ulrich Giezendanner",91,"Fraktion der Schweizerischen Volkspartei"
"214","Urs Gasche_Fraktion BD",3226,3917,3808,0.823589481746234,109,"Urs Gasche",4071,"Fraktion BD"
"215","Urs Schläfli_Fraktion CVP-EVP",3836,4466,4389,0.858934169278997,77,"Urs Schläfli",4122,"Fraktion CVP-EVP"
"216","Ursula Haller Vannini_Fraktion BD",2435,2958,2928,0.823191345503719,30,"Ursula Haller Vannini",472,"Fraktion BD"
"217","Ursula Schneider Schüttel_Sozialdemokratische Fraktion",2228,3786,3729,0.588483888008452,57,"Ursula Schneider Schüttel",4123,"Sozialdemokratische Fraktion"
"218","Ursula Wyss_Sozialdemokratische Fraktion",631,1073,1046,0.58807082945014,27,"Ursula Wyss",522,"Sozialdemokratische Fraktion"
"219","Valérie Piller Carrard_Sozialdemokratische Fraktion",2438,4149,4091,0.587611472644011,58,"Valérie Piller Carrard",4109,"Sozialdemokratische Fraktion"
"220","Verena Herzog_Fraktion der Schweizerischen Volkspartei",1750,2996,2942,0.58411214953271,54,"Verena Herzog",4129,"Fraktion der Schweizerischen Volkspartei"
"221","Viola Amherd_Fraktion CVP-EVP",3601,4273,4165,0.84273344254622,108,"Viola Amherd",1288,"Fraktion CVP-EVP"
"222","Walter Müller_FDP-Liberale Fraktion",3277,4305,4119,0.761207897793264,186,"Walter Müller",1137,"FDP-Liberale Fraktion"
"223","Walter Wobmann_Fraktion der Schweizerischen Volkspartei",2518,4407,4349,0.571363739505332,58,"Walter Wobmann",1142,"Fraktion der Schweizerischen Volkspartei"
"224","Yannick Buttet_Fraktion CVP-EVP",3522,4220,4055,0.834597156398104,165,"Yannick Buttet",4086,"Fraktion CVP-EVP"
"225","Yvan Perrin_Fraktion der Schweizerischen Volkspartei",1224,1950,1924,0.627692307692308,26,"Yvan Perrin",1145,"Fraktion der Schweizerischen Volkspartei"
"226","Yves Nidegger_Fraktion der Schweizerischen Volkspartei",2205,3865,3748,0.570504527813713,117,"Yves Nidegger",3898,"Fraktion der Schweizerischen Volkspartei"
"227","Yvette Estermann_Fraktion der Schweizerischen Volkspartei",2564,4495,4451,0.570411568409344,44,"Yvette Estermann",3876,"Fraktion der Schweizerischen Volkspartei"
"228","Yvonne Feri_Sozialdemokratische Fraktion",2559,4444,4300,0.575832583258326,144,"Yvonne Feri",4069,"Sozialdemokratische Fraktion"
"229","Yvonne Gilli_Grüne Fraktion",2278,3888,3748,0.585905349794239,140,"Yvonne Gilli",3881,"Grüne Fraktion"
